20
20
12121212121212121212
20000000000000000001
10000000000120000002
20000000000000000001
10000000000000000002
20000000000000000001
10012000000001200002
20021000000002100001
10000000000000000002
20000000000000000001
10000000000000000002
20002000000000000001
10000000000000000002
20000000000000000001
10000000000000000002
20000000000000100001
10000000000000000002
21212121212121212121